



    111633111211
   1aaaaooaaa aa1
   1            1
   4            1
   1            1
   1            5
   1            1
   1            1
   a111117811111a
    aaaaaaaaaaaa